###############################
#p     ** *    *   *  * * *   #
# # # #*# # #*#*# # # #*#*#*# #
#   *     ***         *   * * #
# # # # # #*# #*#*#*# # # # #*#
#            **  *  *   1     #
# # # # # # # # # # # #*# # # #
#*  *      *  *      *        #
# # # # #*# # # # #*# # # # # #
#*    **  *       *        1  #
# #*# # # # # # #*# # # # # # #
#           *   *  *          #
###############################